1111111111111
10010C00000C1
1000000111001
1P0010E1000C1
10010C00000C1
1111111111111
