1111111111111
10000C00000C1
10000000P0001
100000E0000C1
10000C00000C1
1111111111111
